#########################################
#                                       #
#                                       #
#                                       #
#                                       #
#                                       #
#                                       #
#                                       #
#                                       #
#          ###################          #
#                                       #
#                                       #
#                                       #
#                                       #
#                                       #
#                                       #
#                                       #
#                                       #
#                                       #
#                                       #
#                                       #
#########################################