#########################################
#                                       #
#                                       #
#        ### #   # ### ### # # ###      #
#        # # ## ## # # #   # # #        #
#        ### # # # # # # # # #  #      #
#        # # #   # ### ### ### ###      #
#                                       #
#                                       #
#                                       #
#                                       #
#                                       #
#                                       #
#                                       #
#                                       #
#                                       #
#                                       #
#                                       #
#                                       #
#                                       #
#                                       #
#                                       #
#                                       #
#                                       #
#                                       #
#########################################